===================
=oooooooo=oooooooo=
=p==o===o=o===o==p=
=ooooooooooooooooo=
=o==o=o=====o=o==o=
=oooo=ooo=ooo=oooo=
====o===.=.===o====
====o=.......=o====
====o=.=====.=o====
....o..=====..o....
====o=.=====.=o====
====o=...P...=o====
====o=.=====.=o====
=oooooooo=oooooooo=
=o==o===o=o===o==o=
=po=ooooooooooo=op=
==o=o=o=====o=o=o==
=oooo=ooo=ooo=oooo=
=o======o=o======o=
=ooooooooooooooooo=
===================
