===================
=oooooooo=oooooooo=
=o==o===o=o===o==o=
=ooooooooooooooooo=
=o==o=o=====o=o==o=
=oooo=ooo=ooo=oooo=
====o===.=.===o====
====o=.......=o====
====o=.=====.=o====
....o..=====..o....
====o=.=====.=o====
====o=...p...=o====
====o=.=====.=o====
=oooooooo=oooooooo=
=o==o===o=o===o==o=
=oo=ooooooooooo=oo=
==o=o=o=====o=o=o==
=oooo=ooo=ooo=oooo=
=o======o=o======o=
=ooooooooooooooooo=
===================
